WPG  G   B
WWWWWWWWWS
         S
SWWW tt WW
S
SWWWWW  WW
S  g     m
WWWWWWWSWW
 m     S H
WWWWWWWWWW
